+-+-+-+-+-+
|   |   | |
+ + + + + +
| | |   | |
+ + +-+ + +
|   |   | |
+ +-+-+ + +
|     | | |
+-+-+ + + +
|         |
+-+-+-+-+-+
