+-+-+-+-+-+-+-+-+-+-+-+-+-+-+-+-+-+-+-+-+-+-+-+-+-+-+-+-+-+-+-+-+-+-+-+-+-+-+-+-+-+-+-+-+-+-+-+-+-+-+
| | | |   | | |       | | |   |   | | |     |   | |   |   |     |   | |     |   | | | |         |   |
+ + + + +-+ + +-+ +-+-+ + +-+ + + + + + + +-+-+ + + + + + + + + + +-+ +-+-+ + +-+ + + + +-+-+ + + + +
| |       | | |       | | | | | |       |   |   | | |   | | | |     | | |     |     |     |   | | | |
+ + +-+ + + + +-+ + + + + + + +-+ + +-+ +-+ + +-+ + +-+-+-+ +-+-+-+ + + +-+-+ + + + + + + +-+-+ +-+ +
|     | |     | | | |   | |   |   | |   |       | | | | |     |   |     |       | | | | | | | | | | |
+ +-+ + + +-+-+ +-+ + + + +-+ + + +-+-+-+-+-+-+-+ + + + +-+-+ + +-+-+-+ + +-+ + + +-+ + +-+ + + + + +
|   | | | | |   | | | |     |   |   |   | | | | |   |     |   |   | |       | | | |   |       |   | |
+-+ + +-+ + + + + +-+-+-+-+ +-+ + +-+-+ + + + + + +-+ +-+-+ +-+-+ + + +-+ +-+-+-+ + +-+ + + + + +-+ +
|   | | |   | | |     | |   | | | |     | | |     |   |             | |   | |     | | | | | | |     |
+ +-+ + + + + +-+ + +-+ +-+ + +-+ +-+ +-+ + + + + + + + + + +-+-+ + +-+-+ + + + +-+ + +-+ +-+ +-+ + +
|   | |   | |     | |     | | |   |       | | | |   |   | | |   | | | |   |   |   | | | |   |   | | |
+-+-+ +-+-+ +-+ + + +-+-+ + + + +-+ + +-+ + +-+-+ +-+ + +-+-+ +-+-+ + +-+ +-+-+ +-+ + + + +-+-+ + + +
|         |   | | |   | | | |   |   |   | |   |     | | |     | | | |         |         |     | | | |
+-+-+ +-+-+-+-+-+ +-+ + + + + +-+-+ +-+ +-+ +-+ + +-+-+ +-+-+ + + +-+ +-+ +-+-+ +-+ + +-+-+ + + +-+ +
|   | |             | | | | |       | | |       |     | |         | |   |   | |   | |   |   | |   | |
+-+ + + +-+ +-+-+-+-+ + + + +-+ + + + + + +-+-+-+-+-+ + +-+ + +-+ + +-+ +-+ + + +-+ + + + + + + + +-+
| | | |   |   |               | | |   | |           | |   | |   |     |   | | | | | | | | | | | |   |
+ + + +-+ +-+-+ +-+-+-+-+-+ +-+ +-+-+ + +-+-+-+-+ +-+-+ + + + +-+-+ +-+ +-+-+ + + +-+-+-+-+ +-+-+-+-+
|     | | |   |           | |   |   | | |   |   | |     | | |     |   |       | |   |     |   | | | |
+ +-+ + + + + +-+ + +-+ +-+ + +-+ +-+ + +-+ +-+ + + + + +-+ + +-+-+-+-+ +-+-+ + +-+ + +-+ + + + + + +
| |     |   | | | |   |   | | |   | | |         | | | | | | |     |   | |   | | |   |   | | |   |   |
+-+-+-+ + + +-+ + + +-+-+ + + +-+ + + +-+ +-+ + +-+-+ + + +-+-+ + + + + + +-+ + + + +-+-+ +-+ + +-+ +
| |       |     | | | |   | |       | | | |   |   |   | | |   | | | | | | | | |   |       | | | | | |
+ + +-+ + + + +-+ + + + + + + +-+-+-+ + +-+-+-+-+ +-+-+ + + + +-+ +-+ + + + + + +-+ + +-+-+ +-+ + + +
|     | | | |   | |   | | |     | | | |         | | | | |   |     | |       | | |   | | | |       | |
+ +-+-+ +-+-+-+-+ +-+ + +-+ +-+ + + + +-+-+ + +-+ + + + +-+-+ + + + + + + +-+-+-+-+-+ + + +-+-+ + + +
|   | | | | |   |   | | |   |     | | |   | | | |   |   | |   | | |   | |   |   | | | |   | |   | | |
+ +-+ + + + + + +-+ + +-+-+-+ +-+ + + + + +-+ + + +-+ +-+ +-+-+ +-+-+-+ +-+-+-+ + + + +-+ + + +-+ + +
| |   | |     | |   | |   | | |   |   | |   |   | |   |     |     | |   | |       | | |         |   |
+ +-+ + +-+-+-+ + +-+-+-+ + + + + + + +-+ + + +-+ +-+ +-+ + + + +-+ +-+ + +-+-+-+ + +-+ +-+ +-+-+ +-+
| | |           | |           | | | |     | | | | |     | | | | | | |     | | | | |   |   | | |   | |
+ + +-+-+-+ + +-+ +-+ + +-+ +-+-+-+-+ + + + + + + + +-+-+-+ + +-+ + +-+ + + + + + +-+ + +-+ + +-+ + +
|       |   |   |   | | |     | | |   | | | | | | | | |   |     |     | | |   |   | |     |     | | |
+-+-+ +-+-+ + +-+ +-+ +-+ + +-+ + +-+ +-+ + + + + + + + + + +-+ +-+ + +-+ + + + + + +-+-+ +-+ + +-+ +
| | |   | | | |     | | | | |   | |     | | | | | |   | | | |   | | |   |   | | |     |   |   |     |
+ + +-+ + +-+ +-+ +-+-+ +-+ + + + +-+ +-+-+ + + + + +-+ +-+-+-+ + + +-+-+-+ +-+-+ +-+-+ + + + +-+ +-+
| | |       | |   |         | | | |     | | |   |     | |   |       |   |             | | | | | |   |
+ + +-+ + +-+-+ +-+ + +-+ + + + + +-+ +-+ + + + + +-+-+ + + + +-+-+ +-+ + +-+ + + +-+ +-+ + +-+ + + +
|     | |     |   | | |   | | |   |       | | |   | | |   |   | |     | |   | | |   |   | |   | | | |
+-+ +-+ + +-+-+ + +-+ +-+-+-+ + +-+-+-+-+ +-+-+ + + + + + + +-+ + + +-+ +-+-+-+-+ + +-+-+-+ +-+ + +-+
|     | | | |   |   |         | |     | |   |   | |   | | |   |   |   |     | | | |     |   |   | | |
+-+ + + + + + +-+ + + + + +-+ +-+ + + + +-+ + +-+-+-+ +-+-+-+-+-+-+ + + +-+-+ + + + +-+-+ + + +-+ + +
| | | | |   |   | | | | | |       | | |   | |         | | | | |     | |     | |   |     | |     | | |
+ + +-+-+ + + + + +-+-+ +-+-+-+ +-+-+-+ +-+-+-+-+ + + + + + + +-+-+ +-+-+-+ + +-+ + + + + +-+-+ + + +
|     |   | | | | | | |   |           |         | | |   |     | | |   |       |   | | | |     | |   |
+ + +-+ +-+ + + + + + +-+-+ +-+ + +-+ +-+-+-+ + +-+-+ + + +-+ + + + +-+-+ +-+-+ + +-+ + + +-+ + + + +
| |   |   | | | | | | |       | | |   |     | |       | | |     | |   |     |   |   | | | | | | | | |
+-+ + +-+-+ +-+-+-+ + +-+-+-+ + + +-+-+ +-+ + + +-+ + +-+-+ + + + +-+ +-+ +-+-+-+-+ +-+ +-+ + + +-+-+
| | | |       | | |   | | |   | |   | | | |   |   | | |   | | | | |         | | |     |   | | | |   |
+ +-+ + +-+ +-+ + + + + + + + + +-+ + + + +-+ +-+-+ +-+ +-+-+ + + + +-+-+ +-+ + + +-+-+ +-+ + +-+ + +
|     | | |         | | |   | | | |   | | |   | | | |   | | | | |     | |   | | | | | | | | |     | |
+-+ + + + +-+ + + +-+ + + + + + + +-+ + + +-+ + + + +-+ + + + + +-+ + + +-+ + + + + + + + + + +-+-+-+
|   | | | |   | |   | |   | | | | | | | |   | |   | | | |   | |   | | | |   | | | |         |   |   |
+ + +-+ + + +-+ + + + +-+ +-+ + + + + + +-+ + + +-+ + + +-+ +-+-+ +-+ + + + + + + +-+ + +-+ + + +-+ +
| |     | |   | | | | |   |   | |   | |   | |   |   | | |       | |   |   | | | | | | |   | | |   | |
+-+ + +-+ + +-+ +-+-+ + +-+-+ + +-+ + + +-+ +-+-+-+ + + + +-+ +-+ + + + +-+ + + + + + + + + +-+ + + +
| | |   | | |     | | |   | | | | |   |   | | | | | |       |   |   | |   | | | |   | | | | |   | | |
+ +-+ + + +-+-+ +-+ +-+-+ + +-+ + + + + +-+ + + + + +-+ +-+ +-+ +-+-+-+ + +-+ + + +-+-+ + + +-+-+-+ +
| | | | | | | |     | | |     |   | | |   |     | | |   |   |     | |   |     | |   | | | |   | |   |
+ + + +-+ + + + +-+-+ + +-+-+-+-+-+-+ + + + + +-+ + +-+ +-+ +-+-+-+ +-+ +-+-+-+ + +-+ + +-+-+-+ +-+ +
|   | | |   |   | |   |   |     | | | | |   | | | | | |   |   | |         |   | | | | | | |     | | |
+-+ + + + + + +-+ + + + + + + + + + + + +-+ + + + + + +-+ +-+ + +-+ + +-+ +-+ + + + + + + + + + + + +
|   | |   | |       | | |   | |   |   |   | |     | |     | | | | | |   |   |   |     | | | | |     |
+ + + +-+-+ + + +-+ +-+-+ +-+ + + + + + +-+ + + +-+-+ + +-+ + + + + + +-+-+ +-+ + +-+-+ + + +-+ + +-+
| | | | | | | |   | |       | | |   | |   | | | | |   | | |   |     | | | | |   |     | | |   | | | |
+-+ + + + + +-+-+-+-+-+ +-+ +-+-+-+-+-+ +-+ +-+ + + +-+ + + +-+-+-+ + + + + +-+ +-+-+-+ + +-+-+-+ + +
| | | | | |   | | | |   |       |         |   | |   |     |       | |   |           |     |     | | |
+ + + + + + + + + + +-+-+-+ +-+ + + +-+ + +-+-+ +-+-+ +-+ + + + +-+-+ +-+ +-+ + +-+ + +-+ + +-+ + + +
|       |   |   | | |   |   |   | | | | |   | |     |   | | | | | |   |     | |   |     | | | |   | |
+-+ + + + +-+-+ + + +-+ +-+ +-+ + +-+ + +-+ + + +-+ + +-+ + + +-+ +-+ + + +-+-+ + + +-+-+ + + + +-+ +
|   | | |   |     |     |   | | | | |   | |   | | | |   | | | |     | | |   |   | |     | |   | | | |
+-+-+-+ +-+-+-+ + +-+-+ +-+ + + + + + + + + +-+-+ + + + + + + +-+-+ + +-+-+-+-+ + + +-+-+ + +-+ + + +
| | |   |   |   | | | | |     | | | | |   |     |     | | | | |     | |     |   | | |     | | | | | |
+ + +-+ +-+ +-+-+ + + + +-+-+-+ +-+ + + + +-+-+-+-+ + +-+ +-+ + + + + +-+-+ + + + + +-+ +-+ + + + + +
| |       | |   |     |         |     | |   | | | | | | |   |   | | |     |   | | | | | | |   |     |
+ +-+ + +-+ +-+ +-+-+ +-+ +-+-+-+-+ +-+ +-+ + + + +-+ + + + + + + +-+ +-+-+-+ + +-+-+ + + +-+-+-+ +-+
| |   | | |   |         |   |         | | | | | |       | | | | |   |   |   | |   |   | | | | |     |
+ + + + + +-+ + + +-+-+-+ + + + + + +-+ + + + + + +-+-+ + +-+-+-+ + +-+-+-+ + + +-+-+ + + + + +-+ +-+
| | | |   |     | | |   | | | | | | |   |     | |     | | |   | | |     | | | | |       | |     | | |
+ +-+-+ +-+-+-+ +-+ + + +-+ + +-+-+ + + + + +-+ + + +-+ + + + + + +-+-+-+ + + + + + + + + +-+-+ + + +
| |   | | | | |   | | | |   |   |   | | | | |   | | | | | | | | | |           | | | | | |       |   |
+ +-+ + + + + +-+ + + + + +-+-+ +-+-+ +-+-+-+ + + + + + +-+-+ + + + +-+-+ + +-+-+-+-+ +-+ + + + + +-+
|                     | |     |     |         | | |   |         | |     | |         |     | | |     |
+-+-+-+-+-+-+-+-+-+-+-+-+-+-+-+-+-+-+-+-+-+-+-+-+-+-+-+-+-+-+-+-+-+-+-+-+-+-+-+-+-+-+-+-+-+-+-+-+-+-+
